###############
#.....!.......#
#.............#
#.............#
#...*.........#
#.............#
#.............#
###############