@^^^^^^^^^^^^^^^^^^^^^^^@
[+.TTTTTTTT....TTTTTTT.+]
[..TTTTTTTT.##.1222223..]
[..12222223.*..4TTTTT4..]
[E~4~~~~~~4~~~~4~~~~~4~G]
[TT4.!....4TTTT4.#.#.4TT]
[TT4#.#.#.622225..+..gTT]
[TT4...+..TTTTTT.#.#.TTT]
[TT4#.#.#.TTTTTT..!..TTT]
[h2x22222222222222222a2f]
[TT4#.#.#.TTTTTT..F..4.+]
[TT4...!..TTTTTT.#|#.4TT]
[TT4#+#.#.122223..|..d2f]
[TT4..!...4TTTT4.#H#.g#+]
[E~4~~~~~~4~~~~4~~~~~~~G]
[!.62222225....4.!#+.eTT]
[..TTTTTTTT..!.6222225TT]
[+.TTTTTTTT..+.....!..TT]
@vvvvvvvvvvvvvvvvvvvvvvv@