###############
#TTTTTTTTTTTTT#
#T....*4.....T#
#T.A~~~4~~~B.T#
#T.|.F.4...|.T#
#T.|.|.E~G.|.T#
#T.|.H.....|.T#
#T.D~~~~~~~C.T#
#T...........T#
#TTTTT..TTTTTT#
#T.e......###T#
#T.4.h2f..#!.T#
#T.g.....####T#
#T.##........T#
#T.1222a2223.T#
#T.4...4...4.T#
#T.d222x222b.T#
#T.4...4...4.T#
#T.6222c2225.T#
#T...........T#
#TTTTTTTTTTTTT#
###############