###############
#.1223...1223.#
#!4##4.!.4##4.#
#.4##4...4##4.#
#!d22c222c225.#
#.4#.!TTT..!..#
#!4#.TABTT....#
#T4#!TDCTT..!.#
#.4#..TTT.....#
#.4##..!..##..#
#!625#####....#
#.......TT...*#
###############