@^^^^^^^^^^^^^^^^^@
[TTTTTTTTTTTTTTTTT]
[T1222222a222223TT]
[T4!####.4TTTTT4TT]
[T4...!..4TTTTT4TT]
[T4#.AB.#4TT+TTgTT]
[T4#.DC.#4TTTTT*TT]
[T4#....#4TTT.TeTT]
[T4+.!...4TTTTT4TT]
[T4!####.4TTTTT4TT]
[T6222222c222225TT]
[TTTTTTTTTTTTTTTTT]
@vvvvvvvvvvvvvvvvv@