TTTTTTTTTTTTT
T...........T
T...........T
T.##....#...T
T.1222a2223.T
T.4...4...4.T
T.d222x222b.T
T.4...4*..4.T
T.6222c2225.T
T...........T
TTTTTTTTTTTTT
